_______________
|@$$||R$$$$$$$|
||$||$|###|$|||
|$$$$$||$$$$|R|
|$||$||$$|##|$|
|$||$$|$|#|$$$|
|$$$|$|$|#|$|$|
|R|#|$$$||$$|||
|||$$$|#|$$|$&|
||$$|$$$$$||$||
||$|#######|$||
|$$$$||$$$||$||
|##|$$$$|$$$$||
###############